1111111111111111111111111111111
100000000000000000C0000000000X1
1000000000000000000000000000001
1000000000000000000000000000001
1000000000000000000000000000001
10000000000000000000000000000P1
1000000000000000000000000000001
1000000000000000000000000000001
10000000000000000000000000000E1
1111111111111111111111111111111
