1111111111111111111111111111111
1X00000000000000000C00000000001
10000000C100000000000000010C001
1000111111111111111111111100001
1000000000000000000000000100001
10C0000001000000000C000001000P1
100000000000000000000000000C001
1000111111000000000000000100001
10000000C1000000000C000001000E1
1111111111111111111111111111111
